1111111111
1P000C0001
1CCC111001
100E000001
1000C00001
1111111111
