11111111
100P00C1
1CCC1111
100E0001
10000001
11111111
